puella : girl
puer : boy
vir : man
femina : woman
rex : king
regina : queen
domus : house
villa : country house
urbs : city
mare : sea
terra : land
caelum : sky
sol : sun
luna : moon
lux : light
nox : night
arbor : tree
flumen : river
mons : mountain
equus : horse
canis : dog
amicus : friend
amica : friend
rex : king
dea : goddess
deus : god
terra : land
via : road
insula : island
porta : gate
murus : wall
navis : ship
portus : harbor
mons : mountain
ager : field
causa : reason
bellum : war
pax : peace
templum : temple
hortus : garden
forum : forum
